<maps>
    <map name="example1">
    ...@.
    .####
    .....
    ####.
    .X...
    </map>

    <map name="example2">
    ..X..
    #####
    .....
    .@...
    .....
    </map>

    <map name="example3">
    ....@
    #.###
    .....
    ....X
    .....
    </map>

    <map name="example4">
    ###########################################################################################
    #.........#.............#......................#......................#...................#
    #....@....#.............#......................#......................#...................#
    #..........#...................................#..........................................#
    #..........#............########################..............#.##.###....................#
    #.##.#..###.............#....................................#............................#
    #....#..#...............#....................................#............................#
    #....#...#..............#...................................#.............................#
    #.....#..######.........#..................................#..............................#
    #.....#.......##.##.....#.................................#...............................#
    #..........#..#...#.....#.........................#################################.X..####
    #.....#####.......#.....#.........................#...............................#....#..#
    #.....#...........#.....#.........................................................######..#
    ######........######....#.........................#.......................................#
    #.......#.##...........##.........................#.......................................#
    #.#.##................#...........................#.......................................#
    ##############.##############################################################.#############
    #....######...............................................................................#
    #.........................................................................................#
    #.........................................................................................#
    ###########################################################################################
    </map>
</maps>
